#######################################
#       # ##    ##      #####        #
# # ### # ## ## ## #### #   # ######B
# # # # # ## ## ##   ## # ##  #######
# #   # # ## ## #### ##   #  ##
# ## ## # ## ## #### ## ### ########
# ##    ###  ##      ## ###   #####
# ##### #   ##########       ######
# ##### # ##########################
# ####    ####
# ###  ####  #
##### ### # ##
##### ###   ##
A  #  #### ###
## #       ###
##   #########
