#########B####
#       # ####
# ##### # ####
# ####    ####
# ###  ####  #
##### ### # ##
##### ###   ##
A  #  #### ###
## #       ###
##   #########
