################################################
#                                             B#
# ############# ################### ############
#               ################### ############
# ############# ################### ############
# #####                    ######## ############
# ##### ##################             #########
# ##### ############################## #########
# ##### ############################## #########
# #             ###################### #########
# # ########### ###################### #########
# # ##                                         #
# # ## ########################### ########### #
#   ## ########################### ########### #
# #### ########################### ########### #
# #### ########################       ######## #
# #### ###############          ##### ######## #
#                      ######## ##### ######## #
# ############################# #####          #
# ############################# ####### ###### #
#           ################### ####### ###### #
# #########     ############### ####### ###### #
# #############      #####      ####### ###### #
# ##################       ############ ####   #
#A#####################################      ###
################################################
