#################
#          ####B#
#               #
##### ################
###                  #
##### ### ###### ### #
#A                   #
######################
